3222222222222222222222222240322222222222222222222222224
10          .            01010            .          01
10 032222240 03222222240 01010 03222222240 032222240 01
10 010000010 01000000010 01010 01000000010 010000010 01
10 052222260 05222222260 05260 05222222260 052222260 01
10          .     .     .     .     .     .          01
10 032222240 03240 03222222222222240 03240 032222240 01
10 052222260 01010 05222224032222260 01010 052222260 01
10          .01010       01010       01010.          01
522222222240 01052222240 01010 03222226010 032222222226
000000000010 01032222260 05260 05222224010 010000000000
000000000010 01010      .     .      01010 010000000000
000000000010 01010 0322240-032222240 01010 010000000000
222222222260 05260 0103260-052224010 05260 052222222222
Q           .     .01010--,---E01010.     .           Q
222222222240 03240 01052222222226010 03240 032222222222
000000000010 01010 05222222222222260 01010 010000000000
000000000010 01010.                 .01010 010000000000
000000000010 01010 03222222222222240 01010 010000000000
322222222260 05260 05222224032222260 05260 052222222224
10          .     .      01010      .     .          01
10 032222240 03222222240 01010 03222222240 032222240 01
10 052224010 05222222260 05260 05222222260 010322260 01
10     01010.     .     . P   .     .     .01010     01
522240 01010 03240 03222222222222240 03240 01010 032226
322260 05260 01010 05222224032222260 01010 05260 052224
10    .      01010       01010       01010      .    01
10 032222222226052222240 01010 032222260522222222240 01
10 052222222222222222260 05260 052222222222222222260 01
10                      .     .                      01
5222222222222222222222222222222222222222222222222222226
