                                                           
                                                           
    * * * * * * * * * * * * * * * * * * * * * * * * * *    
    *                     *     *                     *    
    *                     *     *                     *    
    * * * * * *     * * * *     * * * *     * * * * * *    
    *         *     *                 *     *         *    
    *         *     *                 *     *         *    
    *     * * * * * * * * * * * * * * * * * * * *     *    
    *     *         *                 *         *     *    
    *     *         *                 *         *     *    
    * * * * * *     *                 *     * * * * * *    
    *         *     * * * * * * * * * *     *         *    
    *         *     *                 *     *         *    
    * * *     * * * *                 * * * *     * * *    
        *     *     *                 *     *     *        
        *     *     *                 *     *     *        
        *     *     *                 *     *     *        
        * * * *     * * * * * * * * * *     * * * *        
        *           *                 *           *        
        *           *                 *           *        
        * * * * * * * * * *     * * * * * * * * * *        
        *                 *     *                 *        
        *                 *     *                 *        
        * * * *     * * * * * * * * * *     * * * *        
        *     *     *                 *     *     *        
        *     *     *                 *     *     *        
    * * *     * * * * * * *     * * * * * * *     * * *    
    *               *     *     *     *               *    
    *               *     *     *     *               *    
    * * * * * * * * *     * * * *     * * * * * * * * *    
                                                           
                                                           