                                                       
  * * * * * * * * * * * *     * * * * * * * * * * * *  
  *         *           *     *           *         *  
  *         *           *     *           *         *  
  *         *           *     *           *         *  
  * * * * * * * * * * * * * * * * * * * * * * * * * *  
  *         *     *                 *     *         *  
  *         *     *                 *     *         *  
  * * * * * *     * * * *     * * * *     * * * * * *  
            *           *     *           *            
            *           *     *           *            
            *     * * * * * * * * * *     *            
            *     *                 *     *            
            *     *                 *     *            
            * * * *                 * * * *            
            *     *                 *     *            
            *     *                 *     *            
            *     * * * * * * * * * *     *            
            *     *                 *     *            
            *     *                 *     *            
  * * * * * * * * * * * *     * * * * * * * * * * * *  
  *         *           *     *           *         *  
  *         *           *     *           *         *  
  * * *     * * * * * * * * * * * * * * * *     * * *  
      *     *     *                 *     *     *      
      *     *     *                 *     *     *      
  * * * * * *     * * * *     * * * *     * * * * * *  
  *                     *     *                     *  
  *                     *     *                     *  
  * * * * * * * * * * * * * * * * * * * * * * * * * *  
                                                       