32222222222222222222222222222222222222222222222222222222222222222222222222224
10A           .         .                           .         .           B01
10 03222222240 032222240 032222222222222222222222240 032222240 03222222240 01
10 01032222260 052222260 052222222222222222222222260 052222260 05222224010 01
10 01010A     .         .                           .         .     B01010 01
10 01010 032222222222240 032222222222222222222222240 032222222222240 01010 01
10 05260 010322222222260 052222222222222222222222260 052222222224010 05260 01
10.     .01010A         .                           .         B01010.     .01
10 03240 01010 032222240 032222222222222222222222240 032222240 01010 03240 01
10 01010 05260 052222260 052222222222222222222222260 052222260 05260 01010 01
10 01010.     .     .   .                           .   .     .     .01010 01
10 01010 03240 03240 03222222222222222222222222222222240 03240 03240 01010 01
10 05260 05260 05260 05222222222222222222222222222222260 05260 05260 05260 01
10.     .     .     .     .                       .     .     .     .     .01
10 03240 03240 03240 03240 03222222222222222222240 03240 03240 01010 03240 01
10 05260 01010 05260 05260 05222222222222222222260 05260 05260 05260 05260 01
10.     .01010.     .   .						    .   .     .01010.     .01
10 01010 01010 032222240 03240-032222222222222222240 032222240 01010 03240 01
10 05260 05260 052222260 01010-052222222222222224010 052222260 05260 05260 01
10.     .     .         .0101-,-----------E-----1010.         .     .     .01
10 03240 03240 032222240 010522222222222222222226010 032222240 03240 03240 01
10 05260 01010 052222260 052222222222222222222222260 052222260 01010 05260 01
10.     .01010.     .   . .           P           . .   .     .01010.     .01
10 03240 01010 03240 03240 03222222222222222222240 03240 03240 01010 03240 01
10 05260 05260 05260 05260 05222222222222222222260 05260 05260 05260 05260 01
10.     .     .     .     .                       .     .     .     .     .01
10 03240 03240 03240 03222222222222222222222222222222240 03240 03240 03240 01
10 01010 05260 05260 05222222222222222222222222222222260 05260 05260 01010 01
10 01010.     .         .                           .         .     .01010 01
10 01010 03240 032222240 032222222222222222222222240 032222240 03240 01010 01
10 05260 01010 052222260 052222222222222222222222260 052222260 01010 05260 01
10.     .01010C         .                           .         D01010.     .01
10 03240 010522222222240 032222222222222222222222240 032222222226010 03240 01
10 01010 052222222222260 052222222222222222222222260 052222222222260 01010 01
10 01010C     .         .                           .         .     D01010 01
10 01052222240 032222240 032222222222222222222222240 032222240 03222226010 01
10 05222222260 052222260 052222222222222222222222260 052222260 05222222260 01
10C           .         .                           .         .           D01
52222222222222222222222222222222222222222222222222222222222222222222222222226