                                                                             
    * * * * * * * * * * * * * * * * * * * * * * * * * * * * * * * * * * *    
  *           *         *                           *         *           *  
  *           *         *                           *         *           *  
  *       * * * * * * * * * * * * * * * * * * * * * * * * * * * * *       *  
  *     *               *                           *               *     *  
  *     *               *                           *               *     *  
  * * * *       * * * * * * * * * * * * * * * * * * * * * * *       * * * *  
  *     *     *         *                           *         *     *     *  
  *     *     *         *                           *         *     *     *  
  *     * * * * * * * * * * * * * * * * * * * * * * * * * * * * * * *     *  
  *     *     *     *                                   *     *     *     *  
  *     *     *     *                                   *     *     *     *  
  * * * * * * * * * * * * * * * * * * * * * * * * * * * * * * * * * * * * *  
  *     *     *     *     *                       *     *     *     *     *  
  *     *     *     *     *                       *     *     *     *     *  
  * * * *     * * * * * * * * * * * * * * * * * * * * * * * * *     * * * *  
  *     *     *         *                           *         *     *     *  
  *     *     *         *                           *         *     *     *  
  * * * * * * * * * * * *                           * * * * * * * * * * * *  
  *     *     *         *                           *         *     *     *  
  *     *     *         *                           *         *     *     *  
  * * * *     * * * * * * * * * * * *   * * * * * * * * * * * *     * * * *  
  *     *     *     *     *                       *     *     *     *     *  
  *     *     *     *     *                       *     *     *     *     *  
  * * * * * * * * * * * * * * * * * * * * * * * * * * * * * * * * * * * * *  
  *     *     *     *                                   *     *     *     *  
  *     *     *     *                                   *     *     *     *  
  *     * * * * * * * * * * * * * * * * * * * * * * * * * * * * * * *     *  
  *     *     *         *                           *         *     *     *  
  *     *     *         *                           *         *     *     *  
  * * * *       * * * * * * * * * * * * * * * * * * * * * * *       * * * *  
  *     *               *                           *               *     *  
  *     *               *                           *               *     *  
  *       * * * * * * * * * * * * * * * * * * * * * * * * * * * * *       *  
  *           *         *                           *         *           *  
  *           *         *                           *         *           *  
    * * * * * * * * * * * * * * * * * * * * * * * * * * * * * * * * * * *    
                                                                             