3222222222222222222222222222222222222222222222222222222222222222222222222222222222224
10. . . . . . . . . . . . . . . . . . . . . . . . . . . . . . . . . . . . . . . . .01
10. . . . . . . . . . . . . . . . . . . . . . . . . . . . . . . . . . . . . . . . .01
10. . . . . . . . . . . . . . . . . . . . . . . . . . . . . . . . . . . . . . . . .01
10. . . . . . . . . . . . . . . . . . . . . . . . . . . . . . . . . . . . . . . . .01
10. . . . . . . . . . . . . . . . . . . . . . . . . . . . . . . . . . . . . . . . .01
10. . . . . . . . . . . . . . . . . . . . . . . . . . . . . . . . . . . . . . . . .01
10. . . . . . . . . . . . . . . . . . . . . . . . . . . . . . . . . . . . . . . . .01
10. . . . . . . . . . . . . . . . . . . . . . . . . . . . . . . . . . . . . . . . .01
10. . . . . . . . . . . . . . . . . . . . . . . . . . . . . . . . . . . . . . . . .01
10. . . . . . . . . . . . . . . . . . . . . . . . . . . . . . . . . . . . . . . . .01
10. . . . . . . . . . . . . . . . . . . . . . . . . . . . . . . . . . . . . . . . .01
10. . . . . . . . . . . . . . . . . . . . . . . . . . . . . . . . . . . . . . . . .01
10. . . . . . . . . . . . . . . . . . . . . . . . . . . . . . . . . . . . . . . . .01
10. . . . . . . . . . . . . . . . . . . . . . . . . . . . . . . . . . . . . . . . .01
10. . . . . . . . . . . . . . . . . . . . . . . . . . . . . . . . . . . . . . . . .01
10. . . . . . . . . . . . . . . . . . . . . . . . . . . . . . . . . . . . . . . . .01
10. . . . . . . . . . . . . . . . . . . . . . . . . . . . . . . . . . . . . . . . .01
10. . . . . . . . . . . . . . . . . . . . . . . . . . . . . . . . . . . . . . . . .01
10. . . . . . . . . . . . . . . . . . . , E . . . . . . . . . . . . . . . . . . . .01
10. . . . . . . . . . . . . . . . . . . . . . . . . . . . . . . . . . . . . . . . .01
10. . . . . . . . . . . . . . . . . . . . . . . . . . . . . . . . . . . . . . . . .01
10. . . . . . . . . . . . . . . . . . . . . . . . . . . . . . . . . . . . . . . . .01
10. . . . . . . . . . . . . . . . . . . . . . . . . . . . . . . . . . . . . . . . .01
10. . . . . . . . . . . . . . . . . . . . . . . . . . . . . . . . . . . . . . . . .01
10. . . . . . . . . . . . . . . . . . . . . . . . . . . . . . . . . . . . . . . . .01
10. . . . . . . . . . . . . . . . . . . . . . . . . . . . . . . . . . . . . . . . .01
10. . . . . . . . . . . . . . . . . . . . . . . . . . . . . . . . . . . . . . . . .01
10. . . . . . . . . . . . . . . . . . . . . . . . . . . . . . . . . . . . . . . . .01
10. . . . . . . . . . . . . . . . . . . . P . . . . . . . . . . . . . . . . . . . .01
10. . . . . . . . . . . . . . . . . . . . . . . . . . . . . . . . . . . . . . . . .01
10. . . . . . . . . . . . . . . . . . . . . . . . . . . . . . . . . . . . . . . . .01
10. . . . . . . . . . . . . . . . . . . . . . . . . . . . . . . . . . . . . . . . .01
10. . . . . . . . . . . . . . . . . . . . . . . . . . . . . . . . . . . . . . . . .01
10. . . . . . . . . . . . . . . . . . . . . . . . . . . . . . . . . . . . . . . . .01
10. . . . . . . . . . . . . . . . . . . . . . . . . . . . . . . . . . . . . . . . .01
10. . . . . . . . . . . . . . . . . . . . . . . . . . . . . . . . . . . . . . . . .01
10. . . . . . . . . . . . . . . . . . . . . . . . . . . . . . . . . . . . . . . . .01
10. . . . . . . . . . . . . . . . . . . . . . . . . . . . . . . . . . . . . . . . .01
10. . . . . . . . . . . . . . . . . . . . . . . . . . . . . . . . . . . . . . . . .01
10. . . . . . . . . . . . . . . . . . . . . . . . . . . . . . . . . . . . . . . . .01
5222222222222222222222222222222222222222222222222222222222222222222222222222222222226