99999999999999999999999999999999999999999999999999999999999999999999999999999999999999999
99322222222222222222222222222222222222222222222222222222222222222222222222222222222222499
9910. . . . . . . . . . . . . . . . . . . . . . . . . . . . . . . . . . . . . . . . .0199
9910. . . . . . . . . . . . . . . . . . . . . . . . . . . . . . . . . . . . . . . . .0199
9910. . . . . . . . . . . . . . . . . . . . . . . . . . . . . . . . . . . . . . . . .0199
9910. . . . . . . . . . . . . . . . . . . . . . . . . . . . . . . . . . . . . . . . .0199
9910. . . . . . . . . . . . . . . . . . . . . . . . . . . . . . . . . . . . . . . . .0199
9910. . . . . . . . . . . . . . . . . . . . . . . . . . . . . . . . . . . . . . . . .0199
9910. . . . . . . . . . . . . . . . . . . . . . . . . . . . . . . . . . . . . . . . .0199
9910. . . . . . . . . . . . . . . . . . . . . . . . . . . . . . . . . . . . . . . . .0199
9910. . . . . . . . . . . . . . . . . . . . . . . . . . . . . . . . . . . . . . . . .0199
9910. . . . . . . . . . . . . . . . . . . . . . . . . . . . . . . . . . . . . . . . .0199
9910. . . . . . . . . . . . . . . . . . . . . . . . . . . . . . . . . . . . . . . . .0199
9910. . . . . . . . . . . . . . . . . . . . . . . . . . . . . . . . . . . . . . . . .0199
9910. . . . . . . . . . . . . . . . . . . . . . . . . . . . . . . . . . . . . . . . .0199
9910. . . . . . . . . . . . . . . . . . . . . . . . . . . . . . . . . . . . . . . . .0199
9910. . . . . . . . . . . . . . . . . . . . . . . . . . . . . . . . . . . . . . . . .0199
9910. . . . . . . . . . . . . . . . . . . . . . . . . . . . . . . . . . . . . . . . .0199
9910. . . . . . . . . . . . . . . . . . . . . . . . . . . . . . . . . . . . . . . . .0199
9910. . . . . . . . . . . . . . . . . . . . . . . . . . . . . . . . . . . . . . . . .0199
9910. . . . . . . . . . . . . . . . . . . , E . . . . . . . . . . . . . . . . . . . .0199
9910. . . . . . . . . . . . . . . . . . . . . . . . . . . . . . . . . . . . . . . . .0199
9910. . . . . . . . . . . . . . . . . . . . . . . . . . . . . . . . . . . . . . . . .0199
9910. . . . . . . . . . . . . . . . . . . . . . . . . . . . . . . . . . . . . . . . .0199
9910. . . . . . . . . . . . . . . . . . . . . . . . . . . . . . . . . . . . . . . . .0199
9910. . . . . . . . . . . . . . . . . . . . . . . . . . . . . . . . . . . . . . . . .0199
9910. . . . . . . . . . . . . . . . . . . . . . . . . . . . . . . . . . . . . . . . .0199
9910. . . . . . . . . . . . . . . . . . . . . . . . . . . . . . . . . . . . . . . . .0199
9910. . . . . . . . . . . . . . . . . . . . . . . . . . . . . . . . . . . . . . . . .0199
9910. . . . . . . . . . . . . . . . . . . . . . . . . . . . . . . . . . . . . . . . .0199
9910. . . . . . . . . . . . . . . . . . . . P . . . . . . . . . . . . . . . . . . . .0199
9910. . . . . . . . . . . . . . . . . . . . . . . . . . . . . . . . . . . . . . . . .0199
9910. . . . . . . . . . . . . . . . . . . . . . . . . . . . . . . . . . . . . . . . .0199
9910. . . . . . . . . . . . . . . . . . . . . . . . . . . . . . . . . . . . . . . . .0199
9910. . . . . . . . . . . . . . . . . . . . . . . . . . . . . . . . . . . . . . . . .0199
9910. . . . . . . . . . . . . . . . . . . . . . . . . . . . . . . . . . . . . . . . .0199
9910. . . . . . . . . . . . . . . . . . . . . . . . . . . . . . . . . . . . . . . . .0199
9910. . . . . . . . . . . . . . . . . . . . . . . . . . . . . . . . . . . . . . . . .0199
9910. . . . . . . . . . . . . . . . . . . . . . . . . . . . . . . . . . . . . . . . .0199
9910. . . . . . . . . . . . . . . . . . . . . . . . . . . . . . . . . . . . . . . . .0199
9910. . . . . . . . . . . . . . . . . . . . . . . . . . . . . . . . . . . . . . . . .0199
9910. . . . . . . . . . . . . . . . . . . . . . . . . . . . . . . . . . . . . . . . .0199
99522222222222222222222222222222222222222222222222222222222222222222222222222222222222699
99999999999999999999999999999999999999999999999999999999999999999999999999999999999999999