32222222222222222222224032222222222222222222222222222222224032222222222222222222224
10                   01010                               01010                   01
10 03222222222222240 01010 03222222222222222222222222240 01010 03222222222222240 01
10 01032222222222260 05260 05222222222222222222222222260 05260 05222222222224010 01
10 01010            .     .                             .     .            01010 01
10 01010 03222222222222240 03240-03222222222222222222240 03222222222222240 01010 01
10 05260 05222222222222260 01010-05222222222222222224010 05222222222222260 05260 01
10.     .                 .0101-,---------------E---1010.                 .     .01
10 03240 03222222222222240 01052222222222222222222226010 03222222222222240 03240 01
10 01010 05222222222222260 05222222222222222222222222260 05222222222222260 01010 01
10 01010            .     .             P               .     .            01010 01
10 01052222222222240 03240 03222222222222222222222222240 03240 03222222222226010 01
10 05222222222222260 01010 05222222222222222222222222260 01010 05222222222222260 01
10                   01010                               01010                   01
52222222222222222222226052222222222222222222222222222222226052222222222222222222226