3222222222222222222222222222222222222222222222222222222222222222222222222222222222224
10            .               .                       .       .       .            01
10 03222222240 0322240 0322240 03222222222222222222240 0322240 0322240 03222222240 01
10 05222222260 0522260 0522260 05222222222222222222260 0522260 0522260 05222222260 01
10.           .       .       .                       .       .       .           .01
10 032222222222222222222222240 03240-03222222222222240 032222222222222222222222240 01
10 01                       10 01010-05222222222224010 01                       10 01
10 01                       10 0101-,-----------E-1010 01                       10 01
10 052222222222222222222222260 01052222222222222226010 052222222222222222222222260 01
10.               .           .05222222222222222222260.           .               .01
10 032222222222240 03222222240            P            03222222240 032222222222240 01
10 01           10 01       52222222222222222222222222226       10 01           10 01
10 052222222222260 05222222222222222222222222222222222222222222260 052222222222260 01
10                .                                               .                01
5222222222222222222222222222222222222222222222222222222222222222222222222222222222226