                                                                                         
                                                                                         
    * * * * * * * * * * * * * * * * * * * * * * * * * * * * * * * * * * * * * * * * *    
    *           *       *       *                       *       *       *           *    
    *           *       *       *                       *       *       *           *    
    * * * * * * * * * * * * * * * * * * * * * * * * * * * * * * * * * * * * * * * * *    
    *                           *                       *                           *    
    *                           *                       *                           *    
    *                           *                       *                           *    
    *                           *                       *                           *    
    * * * * * * * * * * * * * * *                       * * * * * * * * * * * * * * *    
    *               *           * * * * * *   * * * * * *           *               *    
    *               *                                               *               *    
    *               *                                               *               *    
    * * * * * * * * * * * * * * * * * * * * * * * * * * * * * * * * * * * * * * * * *    
                                                                                         
                                                                                         