                                                                                       
                                                                                       
    * * * * * * * * * *     * * * * * * * * * * * * * * * *     * * * * * * * * * *    
    *                 *     *                             *     *                 *    
    *                 *     *                             *     *                 *    
    *     * * * * * * * * * * * * * * * * * * * * * * * * * * * * * * * * * *     *    
    *     *                 *                             *                 *     *    
    *     *                 *                             *                 *     *    
    * * * * * * * * * * * * *                             * * * * * * * * * * * * *    
    *     *                 *                             *                 *     *    
    *     *                 *                             *                 *     *    
    *     * * * * * * * * * * * * * * * * * * * * * * * * * * * * * * * * * *     *    
    *                 *     *                             *     *                 *    
    *                 *     *                             *     *                 *    
    * * * * * * * * * *     * * * * * * * * * * * * * * * *     * * * * * * * * * *    
                                                                                       
                                                                                       